...................................
.................13................
.....13............................
...................................
123.......1223.....................
...4...............................
....4...........123................
...................................
4.......13.....12223...............
.....4.............................
12222223...12222222222223...1222223